#.######.##.######.#.######.##.######.##
.........#......#........#..#......#..##
#..##.##.##..##.##.#..##.##.##..##.##.##
#......#...........#....................
##.############.#####.##.#########.#####
....#....#....#........#....#....#....##
#.######.##.########.######.##.######.##
....#.........#........#.........#......
#.###.###.##############.###.#.###.###..
....#....#....#...G..#S.....#....#....##
#.######.##.########.######.##.######.##
......#..#......#........#..#......#..##
#..##.##.##..##.##.#..#####.##..##.##.##
#........#.........#....#...............
##.##.####.####.#####.##.#########.#####
....#....#....#........#....#....#....##
#.######.##.######.#.######.##.######.##
....#.........#........#.........#......
#.###.###.#.###.####.###.###.#.###.###..
....#....#....#........#....#....#....##
