#S######.#
......#..#
#..##.##.#
#.........
##.##.####
....#....#
#.######.#
....#.....
#.###.###.
....#...G#
