#.######.##.######.#
......#..#......#..#
#..##.##.##..##.##.#
#...................
##.##.#########.####
....#....#....#....#
#.######.##.######.#
....#.........#.....
#.###.###.#.###.###.
....#....#...S#...G#
